2
####################
#.@...IJ........@..#
#............@.....#
#@iii...........j..#
#...........K......#
#@@i...............#
#......H...........#
#......k......h....#
#.@.....@.....j....#
####################
