7
####################
#.@...AB.....@..@..#
#............@.....#
#@aaa....E......b..#
#...........C......#
#@@a......ee....@..#
#......D...........#
#......c......d....#
#.@.....@.....b....#
####################
